
★★★★★★★★★★★★★★★★★★
★　　　　　　　　　　　　　　　　★
★　　★★　西　游　记　★★　　　★
★　　　　　　　　　　　　　　　　★
★★★★★★★★★★★★★★★★★★
